1111111111111
1ECCCCCCCCCC1
1C1C1C1C1C1C1
1C1C1C1C1C1C1
1PCCCCCCCCCC1
1111111111111