11111111111111111111
1PCCCCCCCCCRCCCCCCE1
1CCCCYCCCCCCCC1CCCC1
11111111111111111111