11111111111111111111
1CCCC1CCCCCCCC1CCCC1
1C11C1C111111C1C11C1
1C1CCCCCCCCCYCCCC1C1
1R1C11C110B11C11C1C1
1CCCBCC11E111CCCCCC1
1C1C11C111111C11C1C1
1C1CCCCCCCCCCCCCC1G1
1C11C1C111111C1C11C1
1CCGC1YCCPCCCCRCCCC1
11111111111111111111