11111111111111111111111111
1CCCCCCCCCCC11CCGCCCCCCCC1
1C1111C1111C11C1111C1111C1
1C1111C1111C11C1111C1111C1
1C1111C1111C11C1111C1111C1
1CCCCCYCCCCCCCCCCCCCCCCCC1
1C1111C1C11111111C1C1111C1
1CCBCCC1CCCC11CCCC1CRCCCC1
111111C111101101111C111111
111111C100B00000001C111111
111111C101110011101C111111
1ECCCCC001000000100CCCCCB1
111111C101111111101C111111
111111Y100000000G01C111111
111111C101111111101C111111
1CCCCCCCCCCC11CCCCCCCRCCC1
1C1111C1111C11C1111C1111C1
1CGC11CCCCCCRPCCCCCC11CCC1
111C11C1C11111111C1C11C111
1CCCCCC1CCCC11CCCC1CCYCCC1
1C111111111C11C111111111C1
1CCCCCCCBCCCCCCCCCCCCCCCC1
11111111111111111111111111