1111111111111111111
1CCCCCCCCCCCCCCCCE1
1C111111C1C11111111
1Y1CCCCCC1CCCCCCRC1
1CCC1C11CCB1101CCC1
11111C1111111011111
1CCCCC11111110000G1
1C11111111111111111
1CCCCCCCCGCCCCCCCC1
1C111111C1C111111C1
1C1CYCCCC1CCCCCC1C1
1CCC1C11CCC1101CCC1
11111C1111111011111
1CCCCC11111110000G1
1C11111111111111111
1CCCCCCCCBCCCCCCCC1
1C111111C1C111111C1
1C1CRCCCC1CCCCCC1C1
1CCC1C11CCC1101CCC1
11111C1111111011111
1PCCCC1111111111111
1111111111111111111